1 1 1 1 1 1 1 1 1 1 1 1 1 1 1 1 1 1 1 1
1 4 4 4 4 4 4 4 4 1 1 4 4 4 4 4 4 4 4 1
1 4 1 1 1 4 1 1 4 1 1 4 1 1 4 1 1 1 4 1
1 5 4 4 4 4 4 4 4 4 4 4 4 4 4 4 4 4 5 1
1 4 1 1 1 4 1 4 1 1 1 1 4 1 4 1 1 1 4 1
1 4 4 4 4 4 1 4 4 4 4 4 4 1 4 4 4 4 4 1
1 1 1 1 1 4 1 1 1 4 1 1 1 1 4 1 1 1 1 1
1 1 1 1 1 4 1 4 4 4 4 4 4 1 4 1 1 1 1 1
1 1 1 1 1 4 1 4 1 2 2 1 4 1 4 1 1 1 1 1
3 4 4 4 4 4 4 4 1 2 2 1 4 4 4 4 4 4 4 3
1 1 1 1 1 4 1 4 1 1 1 1 4 1 4 1 1 1 1 1
1 1 1 1 1 4 1 4 4 4 4 4 4 1 4 1 1 1 1 1
1 1 1 1 1 4 1 4 1 1 1 1 4 1 4 1 1 1 1 1
1 4 4 4 4 4 4 4 4 6 1 4 4 4 4 4 4 4 4 1
1 4 1 1 1 4 1 1 1 4 1 4 1 1 4 1 1 1 4 1
1 5 4 4 1 4 1 4 4 4 1 4 4 1 4 1 4 4 5 1
1 4 1 4 1 4 1 4 1 4 4 4 4 1 4 1 4 1 4 1
1 4 1 4 4 4 1 4 1 1 1 1 4 1 4 4 4 1 4 1
1 4 4 4 1 4 4 4 4 4 4 4 4 4 4 1 4 4 4 1
1 1 1 1 1 1 1 1 1 1 1 1 1 1 1 1 1 1 1 1
